**********
*        *
*E****** *
**       *
** *******
**       *
******** *
***      *
*S  ******
**********
