******************************
****            **************
*E   ********** **************
*************** **************
***             **************
*** **************************
*** **************************
*** **************************
***                      *****
************************ *****
************************ *****
*                        *****
* ****************************
* ****************************
*                 ************
***************** ************
*****             ************
***** ************************
*****                       S*
******************************