********************
****            ****
*E   ********** ****
*************** ****
***             ****
*** ****************
*** ****************
*** ****************
*   ****************
* ******************
* *            *****
* * ********** *****
* * ********** *****
* *          * *****
* ********** * *****
* ********** * *****
*            * *****
* ************ *****
* ************S*****
********************
