**************************************************
****            **********************************
*E   ********** **********************************
*************** **********************************
***             **********************************
*** **********************************************
*** **********************************************
*** **********************************************
***                      *************************
************************ *************************
************************ *************************
*                        *************************
* *************************                 ******
* ************************* *************** ******
*                 ********* *************** ******
***************** *********             *** ******
*****             ********************* *** ******
***** ********************************* *** ******
*****                      *S           *** ******
************************** **************** ******
*                          **************** ******
* ***************************************** ******
* *******************                       ******
* ******************  ****************************
* ****************** *****************************
* ******************                            **
* ********************************************* **
* ********************************************* **
* ********************************************* **
*                                           *** **
******************************************* *** **
******************************************* *** **
*******                                     *** **
******* *************************************** **
******* *************************************** **
******* *************************************** **
******* *************************************** **
******* *************************************** **
*******                                 ******  **
*************************************** ****** ***
*************************************** ****** ***
********************************        ****** ***
******************************** *************  **
******************************** ************** **
***                              ************** **
*** ******************************************* **
*** ******************************************* **
*** ******************************************* **
***                                             **
**************************************************
